111111
1P0C01
1011E1
1C0011
111111
